distance_pronoun_antecedent	categorical
number_agreement	categorical
is_proper_noun	categorical
antecedent_position	categorical
case_antecedent	categorical
case_pronoun	categorical
pos_mention	categorical
pos_pronoun	categorical
pos_before_mention_1	categorical
pos_before_mention_2	categorical
pos_after_mention_1	categorical
pos_after_mention_2	categorical
pos_before_pronoun_1	categorical
pos_before_pronoun_2	categorical
pos_after_pronoun_1	categorical
pos_after_pronoun_2	categorical
pos_head_mention	categorical
pos_head_pronoun	categorical
syntactic_function_mention	categorical
syntactic_function_pronoun	categorical
nouns_between_mentions	categorical
pronoun_value	categorical
pronoun_sentence_length	numerical
normalized_distance	numerical
mention_local_score	numerical
tkachenko_embedding	numerical
missing_tkachenko_embedding	categorical
eleri_abstractness_score	numerical
mention_global_score	numerical
